ProteinGroupID,Fasta ID,NumSeq,wt_firstRun,wt_concentrated,rac_firstRun,Rac_concentrated,wt troph,rac trop,max
451,GL50803_100864,9,0,0,34,25,0,59,59
348,GL50803_100906,57,0,0,29,83,0,112,112
122,GL50803_10091,3,0,18,9,7,18,16,18
446,GL50803_100987,2,0,0,0,4,0,4,4
1059,GL50803_101138,32,0,0,11,52,0,63,63
570,GL50803_101212,11,0,0,11,22,0,33,33
54,GL50803_101534,2,0,0,0,3,0,3,3
953,GL50803_10167,64,0,18,111,123,18,234,234
865,GL50803_10181,10,0,0,3,21,0,24,24
168,GL50803_101810,20,0,0,17,26,0,43,43
139,GL50803_101955,4,0,0,3,8,0,11,11
1022,GL50803_102101,45,0,0,88,77,0,165,165
798,GL50803_102108,137,0,54,397,342,54,739,739
765,GL50803_10221,3,0,0,6,7,0,13,13
474,GL50803_10231,4,0,0,0,5,0,5,5
983,GL50803_10239,2,0,0,0,2,0,2,2
171,GL50803_102438,2,0,0,0,4,0,4,4
290,GL50803_102455,2,0,0,0,2,0,2,2
596,GL50803_10255,4,0,0,3,7,0,10,10
183,GL50803_103059,70,0,0,168,125,0,293,293
538,GL50803_10311,8,0,271,6,13,271,19,271
535,GL50803_103125,8,0,0,6,13,0,19,19
563,GL50803_103142,16,0,0,80,39,0,119,119
519,GL50803_10315,2,0,0,0,2,0,2,2
292,GL50803_103285,8,0,0,3,8,0,11,11
475,GL50803_103373,55,0,199,200,228,199,428,428
22,GL50803_103454,8,0,0,3,14,0,17,17
552,GL50803_103709,4,0,0,0,6,0,6,6
18,GL50803_103713,3,0,0,6,5,0,11,11
145,GL50803_103855,5,0,0,0,6,0,6,6
586,GL50803_103878,4,0,0,3,5,0,8,8
377,GL50803_10400,2,0,0,11,5,0,16,16
297,GL50803_104150,6,0,0,3,7,0,10,10
889,GL50803_104685,12,0,18,46,45,18,91,91
952,GL50803_10521,16,0,0,26,41,0,67,67
269,GL50803_10538,10,0,0,9,17,0,26,26
346,GL50803_10570,3,0,0,3,3,0,6,6
666,GL50803_10577,9,0,0,14,12,0,26,26
1073,GL50803_10608,2,0,0,3,1,0,4,4
192,GL50803_10675,2,0,0,0,2,0,2,2
154,GL50803_10698,17,0,0,31,31,0,62,62
965,GL50803_10705,2,0,0,0,4,0,4,4
381,GL50803_10711,2,0,0,0,4,0,4,4
207,GL50803_10778,59,0,0,223,134,0,357,357
787,GL50803_10802,2,0,0,0,3,0,3,3
705,GL50803_10822,2,0,0,3,3,0,6,6
737,GL50803_10856,4,0,0,3,5,0,8,8
26,GL50803_10870,2,0,0,0,2,0,2,2
472,GL50803_10885,5,0,0,0,7,0,7,7
524,GL50803_10971,4,0,0,0,5,0,5,5
480,GL50803_11100,7,0,0,6,10,0,16,16
234,GL50803_11118,14,0,90,9,21,90,30,90
370,GL50803_11125,14,0,0,37,35,0,72,72
485,GL50803_11170,3,0,0,0,3,0,3,3
678,GL50803_111886,3,0,0,0,3,0,3,3
280,"GL50803_111933,GL50803_112801,GL50803_111936",2,0,54,0,1,54,1,54
79,GL50803_111950,39,0,0,26,61,0,87,87
244,GL50803_112063,19,0,0,49,38,0,87,87
1056,"GL50803_112079,GL50803_103676",33,0,0,88,67,0,155,155
851,GL50803_112103,4,0,18,0,3,18,3,18
259,GL50803_11220,7,0,0,6,16,0,22,22
99,GL50803_112258,2,0,0,9,3,0,12,12
941,"GL50803_112304,GL50803_112312",20,0,0,63,46,0,109,109
456,GL50803_112408,6,0,0,0,7,0,7,7
509,GL50803_11247,2,0,90,6,2,90,8,90
339,GL50803_112518,7,0,0,9,9,0,18,18
1026,GL50803_112846,48,0,0,97,86,0,183,183
989,GL50803_112978,2,0,0,0,2,0,2,2
447,GL50803_11299,6,0,0,14,11,0,25,25
438,GL50803_113024,11,0,0,63,28,0,91,91
181,GL50803_113133,11,0,0,26,28,0,54,54
618,GL50803_113284,5,0,0,3,6,0,9,9
93,"GL50803_113450,GL50803_137606",2,0,36,0,1,36,1,36
837,GL50803_113456,6,0,0,0,8,0,8,8
341,GL50803_113531,2,0,0,3,2,0,5,5
24,GL50803_11359,2,0,0,11,4,0,15,15
320,GL50803_113622,3,0,0,3,4,0,7,7
574,GL50803_113673,2,0,0,0,3,0,3,3
572,GL50803_113677,42,0,0,66,76,0,142,142
47,GL50803_113722,21,0,0,11,26,0,37,37
291,GL50803_11380,2,0,0,0,2,0,2,2
602,GL50803_113892,61,0,0,217,174,0,391,391
729,GL50803_11390,59,0,0,191,153,0,344,344
1002,GL50803_114210,2,0,0,0,3,0,3,3
545,GL50803_114307,9,0,0,0,18,0,18,18
261,"GL50803_114442,GL50803_112519,GL50803_92983",4,0,0,3,4,0,7,7
184,GL50803_114497,7,0,0,3,11,0,14,14
968,GL50803_114498,11,0,0,17,30,0,47,47
141,GL50803_114609,14,0,90,6,16,90,22,90
238,GL50803_114623,9,0,0,17,10,0,27,27
180,GL50803_114626,3,0,0,3,3,0,6,6
720,GL50803_114776,16,0,0,20,20,0,40,40
689,GL50803_114777,24,0,0,66,54,0,120,120
834,GL50803_114787,74,748,344,291,288,1092,579,1092
52,GL50803_114885,3,0,0,3,3,0,6,6
577,GL50803_115052,19,0,0,17,28,0,45,45
368,GL50803_115159,6,0,0,9,8,0,17,17
188,"GL50803_115338,GL50803_115337",2,0,0,0,2,0,2,2
978,GL50803_11540,13,0,0,63,41,0,104,104
394,"GL50803_115478,GL50803_115479",8,0,0,9,10,0,19,19
4,GL50803_11613,3,0,0,3,4,0,7,7
789,GL50803_11640,2,0,0,3,4,0,7,7
779,GL50803_11654,75,935,597,394,254,1532,648,1532
739,GL50803_11683,5,0,0,9,7,0,16,16
617,GL50803_11684,7,0,0,17,9,0,26,26
128,GL50803_11720,12,0,0,37,30,0,67,67
486,GL50803_11775,2,0,0,3,2,0,5,5
850,GL50803_11953,25,0,0,49,54,0,103,103
1003,GL50803_11965,2,0,0,0,2,0,2,2
50,GL50803_12035,8,0,0,23,15,0,38,38
387,GL50803_12057,2,0,0,0,3,0,3,3
231,GL50803_12102,9,0,36,23,17,36,40,40
245,"GL50803_121046,GL50803_121045",10,0,54,23,15,54,38,54
383,GL50803_12109,16,0,0,26,25,0,51,51
913,GL50803_12139,5,0,0,14,6,0,20,20
842,GL50803_12216,17,0,0,23,29,0,52,52
102,GL50803_12820,2,0,0,3,3,0,6,6
132,GL50803_12830,4,0,0,9,6,0,15,15
759,GL50803_12920,3,0,0,0,7,0,7,7
310,GL50803_12941,2,0,0,0,2,0,2,2
1074,GL50803_12945,5,0,0,9,10,0,19,19
108,GL50803_12999,6,0,0,17,10,0,27,27
716,GL50803_13000,22,0,0,51,49,0,100,100
263,GL50803_13109,3,0,0,6,8,0,14,14
954,GL50803_13268,9,0,0,26,35,0,61,61
643,GL50803_13273,3,0,0,3,4,0,7,7
694,GL50803_13315,3,0,0,0,4,0,4,4
125,GL50803_13323,5,0,0,3,5,0,8,8
777,GL50803_13329,16,0,36,49,47,36,96,96
806,GL50803_13382,6,0,0,3,12,0,15,15
731,GL50803_13413,2,0,0,9,5,0,14,14
767,"GL50803_134441,GL50803_134442",2,0,0,3,4,0,7,7
274,GL50803_1345,7,0,0,3,16,0,19,19
489,GL50803_13475,19,0,90,26,34,90,60,90
686,"GL50803_135003,GL50803_135002,GL50803_135001",3,0,0,11,5,0,16,16
527,"GL50803_135231,GL50803_14212",3,0,0,3,4,0,7,7
766,GL50803_13561,14,0,18,46,28,18,74,74
933,GL50803_13584,5,0,36,6,8,36,14,36
718,"GL50803_136021,GL50803_101291,GL50803_136020",35,0,18,100,88,18,188,188
845,GL50803_13603,2,0,0,0,3,0,3,3
830,GL50803_13661,2,0,0,0,3,0,3,3
732,GL50803_13700,2,0,0,3,2,0,5,5
587,GL50803_137603,4,0,0,0,5,0,5,5
691,GL50803_137613,21,0,0,88,49,0,137,137
795,GL50803_137617,10,0,289,0,0,289,0,289
568,GL50803_137618,5,0,90,0,1,90,1,90
401,GL50803_137641,4,0,0,6,8,0,14,14
493,GL50803_13766,6,0,0,3,7,0,10,10
57,GL50803_137685,8,0,0,29,17,0,46,46
886,GL50803_137695,3,0,0,0,4,0,4,4
712,GL50803_137698,2,0,0,6,2,0,8,8
92,GL50803_137703,3,0,0,0,4,0,4,4
672,GL50803_137712,9,0,0,0,12,0,12,12
230,GL50803_137713,2,0,0,0,2,0,2,2
233,GL50803_137716,137,374,1013,328,296,1387,624,1387
1015,GL50803_137749,4,0,0,0,4,0,4,4
562,GL50803_137753,21,0,0,23,40,0,63,63
848,GL50803_13864,43,0,0,100,105,0,205,205
534,GL50803_13922,18,0,0,34,31,0,65,65
422,GL50803_14019,10,0,18,34,23,18,57,57
841,GL50803_14054,2,0,0,0,2,0,2,2
656,GL50803_14058,8,0,0,14,10,0,24,24
657,GL50803_14071,14,0,0,11,25,0,36,36
600,GL50803_14086,3,0,0,0,6,0,6,6
1068,GL50803_14091,2,0,36,0,1,36,1,36
248,GL50803_14117,2,0,0,0,2,0,2,2
426,GL50803_14200,14,0,0,43,23,0,66,66
882,GL50803_14225,6,0,0,6,8,0,14,14
332,GL50803_14235,5,0,0,0,9,0,9,9
408,GL50803_14242,6,0,0,3,8,0,11,11
750,GL50803_14317,4,0,0,3,4,0,7,7
971,GL50803_14321,2,0,0,0,3,0,3,3
736,GL50803_14329,2,0,36,9,4,36,13,36
988,GL50803_14346,4,0,0,6,7,0,13,13
575,GL50803_14364,3,0,0,0,3,0,3,3
43,GL50803_14373,56,0,199,143,137,199,280,280
415,GL50803_14400,2,0,0,3,2,0,5,5
1050,GL50803_14436,3,0,0,0,3,0,3,3
473,GL50803_14458,8,0,0,31,17,0,48,48
580,GL50803_14460,2,0,0,0,2,0,2,2
317,GL50803_14469,9,0,0,20,23,0,43,43
119,GL50803_14490,10,0,0,9,19,0,28,28
378,GL50803_14521,22,0,109,71,67,109,138,138
63,GL50803_14551,34,0,0,63,92,0,155,155
96,GL50803_14566,4,0,0,3,6,0,9,9
819,GL50803_14568,13,0,0,20,31,0,51,51
374,GL50803_14584,6,0,0,3,10,0,13,13
1075,GL50803_14620,12,0,0,6,18,0,24,24
899,GL50803_14650,4,0,0,9,6,0,15,15
283,GL50803_14670,2,0,0,6,4,0,10,10
1001,GL50803_14689,5,0,0,9,8,0,17,17
325,GL50803_14691,4,0,0,3,5,0,8,8
747,GL50803_14699,5,0,0,17,15,0,32,32
124,GL50803_14704,3,0,0,9,4,0,13,13
359,GL50803_14712,4,0,0,0,5,0,5,5
974,GL50803_14758,15,0,0,14,28,0,42,42
213,GL50803_14796,6,0,0,6,6,0,12,12
268,GL50803_14800,5,0,0,9,9,0,18,18
182,GL50803_14827,6,0,0,3,6,0,9,9
969,GL50803_14856,8,0,0,11,12,0,23,23
466,GL50803_14859,5,0,0,0,9,0,9,9
363,GL50803_14915,2,0,0,0,3,0,3,3
104,GL50803_14934,3,0,0,0,3,0,3,3
650,GL50803_14939,6,0,0,3,10,0,13,13
894,GL50803_15011,6,0,0,29,18,0,47,47
204,GL50803_15035,9,0,0,20,13,0,33,33
770,GL50803_15054,10,0,0,3,14,0,17,17
916,GL50803_15063,4,0,0,0,5,0,5,5
745,GL50803_15076,3,0,0,0,5,0,5,5
561,GL50803_15097,32,0,36,103,98,36,201,201
920,GL50803_15104,6,0,0,3,9,0,12,12
835,GL50803_15106,25,0,0,40,40,0,80,80
397,GL50803_15148,9,0,0,14,14,0,28,28
945,GL50803_15157,2,0,0,0,5,0,5,5
1,GL50803_15204,11,0,0,40,23,0,63,63
944,GL50803_15213,26,0,0,49,61,0,110,110
417,GL50803_15214,13,0,0,17,21,0,38,38
821,GL50803_15215,8,0,0,17,12,0,29,29
741,GL50803_15218,2,0,0,3,1,0,4,4
966,GL50803_15228,4,0,0,9,8,0,17,17
638,GL50803_15240,4,0,0,9,8,0,17,17
356,GL50803_15244,3,0,0,0,14,0,14,14
73,GL50803_15247,4,0,0,0,5,0,5,5
800,GL50803_15250,2,0,0,3,2,0,5,5
1080,GL50803_15251,22,0,90,88,48,90,136,136
75,GL50803_15306,3,0,0,0,4,0,4,4
514,GL50803_15317,6,0,0,9,8,0,17,17
769,GL50803_15334,7,0,0,3,9,0,12,12
949,GL50803_15339,2,0,0,0,2,0,2,2
400,GL50803_15376,4,0,0,0,6,0,6,6
558,GL50803_15383,5,0,54,26,13,54,39,54
479,GL50803_15398,5,0,0,3,7,0,10,10
583,GL50803_15409,47,0,72,146,106,72,252,252
680,GL50803_15410,27,0,18,74,69,18,143,143
675,GL50803_15411,40,0,18,103,97,18,200,200
393,GL50803_15454,2,0,0,0,2,0,2,2
405,GL50803_15461,2,0,0,3,5,0,8,8
996,GL50803_15476,7,0,0,6,12,0,18,18
985,GL50803_15483,9,0,0,46,19,0,65,65
203,GL50803_15495,5,0,0,3,7,0,10,10
1040,GL50803_15522,9,0,0,9,13,0,22,22
87,GL50803_15538,7,0,0,9,13,0,22,22
299,GL50803_15551,3,0,0,0,6,0,6,6
419,GL50803_15567,44,0,0,160,131,0,291,291
710,GL50803_15591,23,0,0,3,32,0,35,35
749,GL50803_15599,3,0,0,9,4,0,13,13
247,GL50803_15832,7,0,0,11,15,0,26,26
123,GL50803_15869,3,0,0,6,5,0,11,11
287,GL50803_15889,2,0,0,0,2,0,2,2
885,GL50803_15954,10,0,0,9,17,0,26,26
925,GL50803_15987,4,0,0,26,12,0,38,38
611,GL50803_15988,10,0,0,26,16,0,42,42
606,GL50803_16054,3,0,0,0,3,0,3,3
197,GL50803_16076,21,0,109,71,65,109,136,136
67,GL50803_16124,4,0,0,3,6,0,9,9
754,GL50803_16125,2,0,0,3,2,0,5,5
1021,GL50803_16160,4,0,0,9,11,0,20,20
313,GL50803_16202,13,0,0,20,23,0,43,43
1030,GL50803_16222,3,0,0,3,4,0,7,7
963,GL50803_16227,3,0,0,9,6,0,15,15
863,GL50803_16237,3,0,0,0,3,0,3,3
746,GL50803_16265,4,0,0,3,6,0,9,9
246,GL50803_16279,2,0,0,0,2,0,2,2
844,GL50803_16297,3,0,0,0,3,0,3,3
25,GL50803_16298,2,0,0,0,2,0,2,2
852,GL50803_16310,2,0,0,3,2,0,5,5
738,GL50803_16321,5,0,0,0,6,0,6,6
649,GL50803_16342,3,0,0,0,4,0,4,4
793,GL50803_16343,31,0,0,34,58,0,92,92
717,GL50803_16353,41,0,0,74,86,0,160,160
1008,GL50803_16356,6,0,0,6,12,0,18,18
565,GL50803_16363,3,0,0,0,5,0,5,5
404,GL50803_16367,3,0,0,0,3,0,3,3
406,GL50803_16368,5,0,0,6,8,0,14,14
908,GL50803_16375,2,0,0,0,4,0,4,4
593,GL50803_16387,3,0,18,0,3,18,3,18
695,GL50803_16390,2,0,0,3,3,0,6,6
395,GL50803_16404,13,0,0,120,72,0,192,192
529,GL50803_16412,4,0,0,0,5,0,5,5
676,GL50803_16424,2,0,0,0,3,0,3,3
116,GL50803_16425,24,0,0,17,35,0,52,52
305,GL50803_16435,2,0,18,0,2,18,2,18
312,GL50803_16453,2,0,36,3,1,36,4,36
68,GL50803_16454,4,0,0,9,10,0,19,19
285,GL50803_16483,11,0,0,20,23,0,43,43
722,GL50803_16495,4,0,0,14,9,0,23,23
56,GL50803_16504,4,0,0,9,4,0,13,13
329,GL50803_16507,27,0,0,54,69,0,123,123
445,GL50803_16513,4,0,0,0,6,0,6,6
1013,GL50803_16525,8,0,0,9,10,0,19,19
688,GL50803_16532,5,0,0,6,8,0,14,14
199,GL50803_16547,8,0,0,6,10,0,16,16
303,GL50803_16567,4,0,0,6,5,0,11,11
771,GL50803_16573,6,0,0,3,7,0,10,10
773,GL50803_16574,3,0,0,0,5,0,5,5
847,GL50803_16575,3,0,0,3,6,0,9,9
605,GL50803_16588,6,0,18,0,7,18,7,18
994,GL50803_16592,6,0,0,6,17,0,23,23
380,GL50803_16630,2,0,0,0,4,0,4,4
932,GL50803_16636,31,0,18,140,74,18,214,214
816,GL50803_16652,5,0,0,11,9,0,20,20
251,GL50803_16653,18,0,0,54,27,0,81,81
753,GL50803_16659,2,0,0,0,3,0,3,3
700,GL50803_16660,7,0,0,0,14,0,14,14
388,GL50803_16675,2,0,0,0,2,0,2,2
976,GL50803_16679,14,0,0,49,34,0,83,83
581,GL50803_16707,2,0,0,0,2,0,2,2
530,GL50803_16709,13,0,0,0,19,0,19,19
1010,"GL50803_16716,GL50803_21321",2,0,0,0,3,0,3,3
813,GL50803_16720,24,0,0,29,53,0,82,82
309,GL50803_16721,2,0,0,6,3,0,9,9
673,GL50803_16745,18,0,127,20,33,127,53,127
236,GL50803_16772,2,0,0,0,2,0,2,2
344,GL50803_16773,7,0,0,0,10,0,10,10
1031,GL50803_16779,5,0,0,9,16,0,25,25
345,GL50803_16801,2,0,0,0,2,0,2,2
526,GL50803_16804,55,0,0,114,109,0,223,223
421,GL50803_16824,20,0,0,26,29,0,55,55
423,GL50803_16829,5,0,0,0,11,0,11,11
484,GL50803_16839,3,0,0,0,5,0,5,5
492,GL50803_16867,28,0,0,68,67,0,135,135
100,GL50803_16889,7,0,0,9,12,0,21,21
905,GL50803_16906,2,0,0,6,3,0,9,9
316,GL50803_16916,9,0,0,9,14,0,23,23
872,GL50803_16928,11,0,0,9,25,0,34,34
216,GL50803_16929,3,0,0,0,4,0,4,4
258,GL50803_16936,2,0,0,0,3,0,3,3
1053,GL50803_16945,3,0,0,0,4,0,4,4
764,GL50803_1695,15,0,0,57,32,0,89,89
553,GL50803_16966,4,0,0,0,4,0,4,4
515,GL50803_16967,3,0,0,0,3,0,3,3
78,GL50803_16979,2,0,0,9,5,0,14,14
218,GL50803_17005,2,0,0,0,2,0,2,2
12,GL50803_17037,2,0,0,0,2,0,2,2
564,GL50803_17054,17,0,0,26,31,0,57,57
668,GL50803_17056,5,0,0,3,8,0,11,11
636,GL50803_17084,9,0,0,0,11,0,11,11
860,GL50803_17090,8,0,0,9,10,0,19,19
373,GL50803_17105,24,0,0,37,41,0,78,78
425,GL50803_17109,6,0,0,9,7,0,16,16
579,GL50803_17119,2,0,0,0,3,0,3,3
497,GL50803_17121,80,0,217,274,210,217,484,484
482,GL50803_17132,2,0,0,0,2,0,2,2
891,GL50803_17153,26,935,308,103,65,1243,168,1243
878,GL50803_17157,6,0,0,0,13,0,13,13
785,GL50803_17161,2,0,0,3,2,0,5,5
711,GL50803_17165,5,0,0,6,11,0,17,17
566,GL50803_17192,12,0,0,6,17,0,23,23
117,GL50803_17216,2,0,0,0,3,0,3,3
690,GL50803_17224,13,0,0,29,20,0,49,49
881,GL50803_17230,66,0,36,251,163,36,414,414
1066,GL50803_17231,3,0,0,0,4,0,4,4
470,GL50803_17243,15,0,0,3,28,0,31,31
1057,GL50803_17244,3,0,0,0,5,0,5,5
1054,GL50803_17246,5,0,0,9,9,0,18,18
51,GL50803_17249,25,0,18,31,40,18,71,71
314,GL50803_17251,8,0,0,6,10,0,16,16
993,GL50803_17255,3,0,0,6,6,0,12,12
919,GL50803_17265,60,0,0,86,119,0,205,205
138,GL50803_17277,7,0,0,6,14,0,20,20
1046,GL50803_17278,2,0,0,0,3,0,3,3
136,GL50803_17283,5,0,0,0,6,0,6,6
467,GL50803_17286,2,0,0,0,3,0,3,3
1071,GL50803_17304,6,0,0,14,11,0,25,25
846,GL50803_17327,55,0,72,183,224,72,407,407
98,GL50803_17332,9,0,0,20,15,0,35,35
635,GL50803_17337,2,0,0,9,4,0,13,13
357,GL50803_17342,23,0,0,57,48,0,105,105
82,GL50803_17345,2,0,0,0,2,0,2,2
150,GL50803_17347,2,0,0,0,4,0,4,4
1006,GL50803_17352,2,0,0,0,3,0,3,3
625,GL50803_17362,2,0,0,3,2,0,5,5
454,GL50803_17385,7,0,0,0,8,0,8,8
77,GL50803_17395,6,0,0,6,8,0,14,14
955,GL50803_17402,4,0,0,0,4,0,4,4
958,GL50803_17406,3,0,0,3,2,0,5,5
556,GL50803_17411,8,0,0,0,13,0,13,13
937,GL50803_17429,4,0,0,0,5,0,5,5
135,GL50803_17430,4,0,0,0,5,0,5,5
257,GL50803_17464,2,0,0,0,2,0,2,2
411,GL50803_17476,2,0,0,0,2,0,2,2
179,GL50803_17478,27,0,0,14,41,0,55,55
367,GL50803_17482,3,0,0,3,3,0,6,6
631,GL50803_17547,6,0,0,11,11,0,22,22
412,GL50803_17558,4,0,0,6,8,0,14,14
951,GL50803_17565,5,0,0,0,6,0,6,6
560,GL50803_17566,2,0,0,0,2,0,2,2
465,GL50803_17570,6,0,0,6,8,0,14,14
979,GL50803_17577,5,0,0,0,11,0,11,11
427,GL50803_17617,3,0,0,9,6,0,15,15
1027,GL50803_17627,10,0,0,6,16,0,22,22
289,GL50803_18470,15,0,0,26,22,0,48,48
1014,GL50803_19436,6,0,0,6,10,0,16,16
418,GL50803_1979,3,0,0,14,8,0,22,22
211,GL50803_21048,3,0,0,0,4,0,4,4
693,GL50803_2107,19,0,0,31,39,0,70,70
392,GL50803_21118,65,0,0,240,197,0,437,437
66,GL50803_21411,30,0,0,49,57,0,106,106
708,GL50803_21423,30,0,0,60,56,0,116,116
19,GL50803_21474,7,0,0,6,9,0,15,15
788,GL50803_21505,19,0,0,23,33,0,56,56
39,GL50803_21628,20,0,0,46,40,0,86,86
94,GL50803_21803,8,0,0,3,12,0,15,15
186,GL50803_21943,7,0,0,11,20,0,31,31
940,GL50803_22136,4,0,0,9,5,0,14,14
243,GL50803_22165,2,0,0,3,3,0,6,6
998,GL50803_22291,8,0,0,23,14,0,37,37
829,GL50803_22454,4,0,0,11,10,0,21,21
95,GL50803_22455,2,0,0,0,3,0,3,3
598,GL50803_23017,2,0,0,0,2,0,2,2
709,GL50803_23389,7,0,18,6,9,18,15,18
591,GL50803_23833,56,0,18,157,135,18,292,292
27,GL50803_23888,12,0,0,34,22,0,56,56
113,GL50803_24279,7,0,0,11,7,0,18,18
508,GL50803_24372,12,0,0,31,26,0,57,57
284,GL50803_24425,2,0,0,0,2,0,2,2
399,GL50803_2483,2,0,0,0,2,0,2,2
948,GL50803_24842,13,0,0,11,16,0,27,27
594,GL50803_25205,5,0,0,9,10,0,19,19
194,GL50803_25238,3,0,0,9,5,0,14,14
871,GL50803_2549,4,0,0,9,5,0,14,14
510,GL50803_2555,4,0,0,6,7,0,13,13
723,GL50803_2562,25,0,0,40,44,0,84,84
531,GL50803_2622,3,0,0,3,4,0,7,7
396,GL50803_26364,2,0,0,0,2,0,2,2
1045,GL50803_27878,2,0,0,6,2,0,8,8
153,GL50803_27896,2,0,0,0,2,0,2,2
906,GL50803_27925,9,0,0,6,12,0,18,18
791,GL50803_2833,2,0,0,0,2,0,2,2
546,GL50803_28379,6,0,0,3,7,0,10,10
818,GL50803_28433,2,0,0,11,6,0,17,17
64,GL50803_28549,3,0,0,9,4,0,13,13
674,GL50803_2864,3,0,0,0,4,0,4,4
458,GL50803_28699,5,0,0,29,15,0,44,44
198,GL50803_28954,3,0,0,6,3,0,9,9
541,GL50803_29147,14,0,0,43,31,0,74,74
362,GL50803_29487,3,0,0,9,6,0,15,15
30,GL50803_29490,4,0,0,6,12,0,18,18
481,GL50803_2964,3,0,0,3,5,0,8,8
189,GL50803_30476,20,0,0,54,49,0,103,103
890,GL50803_31978,5,0,0,3,7,0,10,10
1025,GL50803_3206,4,0,0,0,6,0,6,6
934,GL50803_32399,24,0,0,43,57,0,100,100
929,GL50803_32419,2,0,0,0,3,0,3,3
441,GL50803_32509,21,0,0,40,32,0,72,72
191,GL50803_3256,3,0,0,0,6,0,6,6
947,GL50803_32571,8,0,0,26,19,0,45,45
888,GL50803_32658,22,0,0,29,46,0,75,75
187,GL50803_32778,5,0,0,6,8,0,14,14
939,GL50803_32999,24,0,0,43,55,0,98,98
337,GL50803_33166,2,0,0,0,4,0,4,4
91,GL50803_33218,3,0,0,6,4,0,10,10
610,GL50803_3342,4,0,0,3,6,0,9,9
267,GL50803_33660,7,0,0,9,14,0,23,23
407,GL50803_33685,2,0,0,0,4,0,4,4
1000,GL50803_33769,12,0,109,37,20,109,57,109
161,GL50803_33862,4,0,0,3,6,0,9,9
931,GL50803_33989,3,0,0,0,4,0,4,4
10,GL50803_3470,3,0,0,3,4,0,7,7
645,GL50803_34701,2,0,0,0,3,0,3,3
439,GL50803_35180,5,0,0,0,6,0,6,6
506,GL50803_3593,5,0,0,9,6,0,15,15
786,GL50803_3595,2,0,0,0,2,0,2,2
870,GL50803_3678,6,0,0,6,9,0,15,15
755,GL50803_37161,2,0,0,0,2,0,2,2
811,GL50803_37985,3,0,0,6,4,0,10,10
997,GL50803_38104,3,0,0,3,5,0,8,8
774,GL50803_38901,8,0,0,29,14,0,43,43
202,GL50803_3896,8,0,18,29,15,18,44,44
58,GL50803_3903,2,0,0,0,2,0,2,2
44,GL50803_39312,7,0,0,0,11,0,11,11
165,GL50803_3977,3,0,0,3,5,0,8,8
1023,GL50803_40224,4,0,0,3,8,0,11,11
733,GL50803_40228,2,0,0,0,3,0,3,3
559,GL50803_40244,10,0,0,26,20,0,46,46
302,GL50803_4026,8,0,0,6,12,0,18,18
84,GL50803_40369,5,0,0,3,7,0,10,10
547,GL50803_4044,3,0,0,0,3,0,3,3
306,GL50803_40496,82,0,0,77,131,0,208,208
651,GL50803_4063,2,0,0,0,4,0,4,4
926,GL50803_41212,10,0,18,0,13,18,13,18
158,GL50803_4152,3,0,0,3,6,0,9,9
1039,GL50803_42285,3,0,0,0,3,0,3,3
14,GL50803_42357,3,0,0,0,3,0,3,3
253,GL50803_4255,4,0,0,9,8,0,17,17
174,GL50803_4259,5,0,0,6,4,0,10,10
266,GL50803_4266,14,0,0,6,23,0,29,29
918,GL50803_4270,2,0,0,3,2,0,5,5
364,GL50803_4331,2,0,0,0,3,0,3,3
65,GL50803_4349,5,0,0,14,4,0,18,18
1034,GL50803_4410,26,0,0,120,64,0,184,184
833,GL50803_4463,3,0,0,9,6,0,15,15
31,GL50803_4507,2,0,0,0,3,0,3,3
235,GL50803_4509,5,0,0,6,12,0,18,18
831,GL50803_4547,5,0,0,14,7,0,21,21
129,GL50803_4602,6,0,0,11,11,0,22,22
434,GL50803_4627,8,0,0,11,8,0,19,19
503,GL50803_4767,16,0,0,26,41,0,67,67
516,GL50803_4812,72,0,127,394,220,127,614,614
630,GL50803_4883,11,0,0,0,13,0,13,13
300,GL50803_5010,2,0,0,0,4,0,4,4
62,GL50803_5161,2,0,0,0,2,0,2,2
59,GL50803_5188,2,0,0,3,2,0,5,5
671,GL50803_5328,3,0,0,0,3,0,3,3
86,GL50803_5359,7,0,0,11,16,0,27,27
8,GL50803_5375,2,0,0,0,2,0,2,2
250,GL50803_5593,2,0,0,0,3,0,3,3
240,GL50803_5603,30,0,0,49,63,0,112,112
496,GL50803_5744,16,0,0,40,41,0,81,81
495,GL50803_5749,3,0,0,0,3,0,3,3
567,GL50803_5784,2,0,0,3,3,0,6,6
1049,GL50803_5785,2,0,0,0,3,0,3,3
701,GL50803_5795,17,0,0,46,42,0,88,88
735,GL50803_5809,11,0,0,9,17,0,26,26
256,GL50803_5845,2,0,0,0,2,0,2,2
126,GL50803_5883,3,0,0,0,4,0,4,4
946,GL50803_5919,2,0,0,3,1,0,4,4
608,GL50803_5927,10,0,0,14,15,0,29,29
864,GL50803_5942,8,0,18,6,11,18,17,18
81,GL50803_5947,3,0,0,9,6,0,15,15
995,GL50803_5981,2,0,0,0,2,0,2,2
101,GL50803_6170,9,0,0,17,25,0,42,42
715,GL50803_6226,6,0,0,0,8,0,8,8
801,GL50803_6262,2,0,0,0,2,0,2,2
38,GL50803_6372,5,0,0,3,10,0,13,13
634,GL50803_6430,4,0,54,6,7,54,13,54
783,GL50803_6464,10,0,0,0,17,0,17,17
778,GL50803_6469,3,0,0,0,4,0,4,4
114,GL50803_6535,3,0,0,0,3,0,3,3
457,GL50803_6617,19,0,0,74,57,0,131,131
622,GL50803_6671,2,0,0,3,2,0,5,5
762,GL50803_6687,3,0,0,3,6,0,9,9
803,GL50803_6735,3,0,0,0,3,0,3,3
152,GL50803_6736,2,0,0,0,2,0,2,2
271,GL50803_6744,3,0,18,0,5,18,5,18
134,GL50803_6886,5,0,0,3,4,0,7,7
223,GL50803_6917,14,0,18,51,34,18,85,85
696,GL50803_7031,6,0,0,9,8,0,17,17
386,GL50803_7035,5,0,0,9,8,0,17,17
923,GL50803_7126,8,0,0,20,17,0,37,37
42,GL50803_7130,11,0,0,17,18,0,35,35
569,GL50803_7204,6,0,0,11,8,0,19,19
1018,GL50803_7233,8,0,0,11,14,0,25,25
824,GL50803_7242,10,0,0,26,24,0,50,50
685,GL50803_7244,13,0,0,60,41,0,101,101
536,GL50803_7259,3,0,0,20,7,0,27,27
641,GL50803_7287,15,0,0,29,30,0,59,59
352,GL50803_7306,2,0,0,0,3,0,3,3
982,GL50803_7309,9,0,0,9,15,0,24,24
215,GL50803_7323,3,0,0,3,3,0,6,6
684,GL50803_7351,3,0,0,0,3,0,3,3
823,GL50803_7373,2,0,0,0,2,0,2,2
799,GL50803_7375,2,0,0,0,2,0,2,2
288,GL50803_7422,2,0,0,3,2,0,5,5
196,GL50803_7439,6,0,0,6,7,0,13,13
838,GL50803_7520,2,0,0,0,2,0,2,2
911,GL50803_7522,3,0,0,0,4,0,4,4
340,GL50803_7524,2,0,0,0,4,0,4,4
70,GL50803_7532,4,0,0,0,5,0,5,5
883,GL50803_7559,3,0,0,0,4,0,4,4
892,GL50803_7588,3,0,0,6,4,0,10,10
120,GL50803_7590,4,0,0,9,8,0,17,17
491,GL50803_7655,2,0,0,3,1,0,4,4
221,GL50803_7789,4,0,0,6,5,0,11,11
460,GL50803_7796,61,0,181,191,179,181,370,370
403,GL50803_7870,2,0,0,0,2,0,2,2
366,GL50803_7873,3,0,0,17,8,0,25,25
1012,GL50803_7909,3,0,0,6,4,0,10,10
46,GL50803_7953,13,0,0,34,27,0,61,61
557,GL50803_7962,2,0,36,0,0,36,0,36
149,GL50803_7999,9,0,0,20,16,0,36,36
849,GL50803_8044,15,0,18,68,45,18,113,113
964,GL50803_8064,2,0,0,0,5,0,5,5
692,GL50803_8118,5,0,0,9,13,0,22,22
270,GL50803_8152,8,0,0,20,16,0,36,36
20,GL50803_8172,8,0,0,11,7,0,18,18
776,GL50803_8227,8,0,0,9,12,0,21,21
661,GL50803_8329,2,0,0,0,2,0,2,2
488,GL50803_8350,3,0,0,3,3,0,6,6
115,GL50803_8377,7,0,0,23,15,0,38,38
873,GL50803_8382,5,0,0,9,9,0,18,18
609,GL50803_8426,20,0,0,11,47,0,58,58
826,GL50803_8429,5,0,0,17,10,0,27,27
461,GL50803_8444,11,0,0,23,20,0,43,43
276,GL50803_8464,17,0,0,23,33,0,56,56
1055,GL50803_8468,13,0,0,34,36,0,70,70
295,GL50803_8496,53,0,0,371,187,0,558,558
319,GL50803_8565,2,0,0,0,2,0,2,2
938,GL50803_86440,3,0,0,3,3,0,6,6
772,GL50803_86468,5,0,0,0,8,0,8,8
55,GL50803_86511,2,0,0,0,3,0,3,3
528,GL50803_86593,5,0,0,3,8,0,11,11
416,GL50803_86676,50,0,0,188,133,0,321,321
328,GL50803_86680,6,0,0,3,8,0,11,11
655,GL50803_86681,2,0,0,0,3,0,3,3
1004,GL50803_86815,3,0,0,0,6,0,6,6
977,GL50803_8702,6,0,0,9,14,0,23,23
499,GL50803_87039,20,0,0,20,29,0,49,49
518,GL50803_87056,3,0,0,0,5,0,5,5
667,GL50803_87058,2,0,0,3,2,0,5,5
170,GL50803_8711,3,0,0,3,2,0,5,5
623,GL50803_87202,4,0,0,0,4,0,4,4
210,GL50803_8741,3,0,0,0,4,0,4,4
582,GL50803_87422,3,0,0,3,5,0,8,8
714,GL50803_87446,2,0,0,0,2,0,2,2
1020,GL50803_8745,5,0,0,3,6,0,9,9
112,GL50803_8781,3,0,0,6,6,0,12,12
697,GL50803_87817,5,0,0,6,5,0,11,11
702,GL50803_87926,3,0,0,0,7,0,7,7
719,GL50803_8805,14,0,0,26,22,0,48,48
262,GL50803_88082,26,0,0,54,51,0,105,105
193,GL50803_8854,4,0,0,6,7,0,13,13
435,GL50803_8855,22,0,0,57,42,0,99,99
390,GL50803_88581,16,0,0,57,34,0,91,91
159,GL50803_88765,44,0,72,128,85,72,213,213
226,GL50803_88960,3,0,0,11,5,0,16,16
137,GL50803_8903,7,0,0,14,13,0,27,27
264,GL50803_8917,5,0,0,9,7,0,16,16
521,GL50803_8978,8,0,36,14,13,36,27,36
554,GL50803_90044,2,0,0,3,4,0,7,7
463,GL50803_9030,11,0,0,31,27,0,58,58
930,GL50803_90434,5,0,0,0,5,0,5,5
6,GL50803_9060,5,0,0,9,8,0,17,17
903,GL50803_9062,40,0,0,117,107,0,224,224
464,GL50803_9077,3,0,0,0,4,0,4,4
507,GL50803_9079,3,0,0,6,4,0,10,10
410,GL50803_91099,3,0,0,0,3,0,3,3
106,GL50803_9121,6,0,0,14,9,0,23,23
1079,GL50803_91220,4,0,0,0,4,0,4,4
241,GL50803_91252,3,0,0,0,6,0,6,6
728,GL50803_91476,2,0,0,0,6,0,6,6
185,GL50803_91480,15,0,0,14,21,0,35,35
338,GL50803_9155,2,0,0,0,3,0,3,3
336,GL50803_9157,2,0,0,0,2,0,2,2
140,GL50803_9173,2,0,0,3,3,0,6,6
687,GL50803_9174,3,0,0,3,8,0,11,11
500,GL50803_91761,5,0,0,0,6,0,6,6
725,GL50803_9183,24,0,0,20,36,0,56,56
590,GL50803_91919,4,0,0,0,7,0,7,7
856,GL50803_9196,5,0,0,11,5,0,16,16
76,GL50803_92223,11,0,0,9,13,0,22,22
533,GL50803_92246,47,0,0,86,87,0,173,173
498,GL50803_92498,2,0,0,3,3,0,6,6
1051,GL50803_92645,3,0,0,0,4,0,4,4
227,GL50803_9296,9,0,0,17,13,0,30,30
459,GL50803_93002,16,0,0,14,26,0,40,40
110,GL50803_93011,3,0,0,3,3,0,6,6
532,GL50803_9327,2,0,0,0,2,0,2,2
713,GL50803_93275,17,0,0,20,30,0,50,50
539,GL50803_93278,6,0,0,6,11,0,17,17
1064,GL50803_93294,7,0,0,9,13,0,22,22
967,GL50803_93358,23,0,253,43,29,253,72,253
409,GL50803_93548,15,0,0,31,35,0,66,66
1007,GL50803_9365,2,0,0,0,3,0,3,3
986,GL50803_93736,23,0,0,17,32,0,49,49
282,GL50803_9413,72,0,36,337,263,36,600,600
1035,GL50803_94224,7,0,0,6,16,0,22,22
620,GL50803_94287,9,0,0,6,15,0,21,21
351,GL50803_94440,73,0,0,46,119,0,165,165
1011,GL50803_94463,10,0,0,11,15,0,26,26
420,GL50803_94525,2,0,0,0,4,0,4,4
371,GL50803_94646,2,0,0,0,2,0,2,2
627,GL50803_94762,2,0,0,0,2,0,2,2
105,GL50803_9489,22,0,0,46,60,0,106,106
607,GL50803_9503,16,0,0,17,46,0,63,63
907,GL50803_9515,11,0,0,9,17,0,26,26
775,GL50803_95192,8,0,0,9,10,0,19,19
740,GL50803_95254,2,0,0,0,2,0,2,2
1061,GL50803_9529,4,0,0,3,8,0,11,11
413,GL50803_95406,2,0,0,0,4,0,4,4
924,GL50803_9548,5,0,0,6,10,0,16,16
935,GL50803_9558,29,0,0,134,82,0,216,216
663,GL50803_9593,40,0,0,74,82,0,156,156
452,GL50803_9620,2,0,0,0,2,0,2,2
901,GL50803_96264,5,0,0,3,6,0,9,9
1028,GL50803_96363,2,0,0,0,2,0,2,2
810,GL50803_96399,11,0,0,0,18,0,18,18
898,GL50803_96460,3,0,0,0,3,0,3,3
34,GL50803_96562,4,0,0,11,10,0,21,21
869,GL50803_96670,31,0,0,100,74,0,174,174
604,GL50803_96732,15,0,0,23,28,0,51,51
542,GL50803_96994,9,0,0,20,12,0,32,32
1044,GL50803_9719,72,0,18,302,208,18,510,510
16,GL50803_9750,5,0,0,3,9,0,12,12
308,GL50803_9751,16,0,0,66,42,0,108,108
324,GL50803_9780,28,0,0,140,77,0,217,217
756,GL50803_98054,31,0,18,94,79,18,173,173
744,GL50803_9807,4,0,0,3,5,0,8,8
861,GL50803_9808,28,0,0,80,60,0,140,140
902,GL50803_9825,5,0,0,0,5,0,5,5
900,GL50803_9829,2,0,0,3,4,0,7,7
904,GL50803_9848,8,0,0,31,28,0,59,59
616,GL50803_9861,24,0,36,60,44,36,104,104
540,GL50803_9900,2,0,0,0,3,0,3,3
751,GL50803_9909,16,0,0,17,31,0,48,48
5,sp|ALBU_BOVIN|,16,1309,742,0,0,2051,0,2051
228,sp|K1C10_HUMAN|,39,4115,1791,68,45,5906,113,5906
2,sp|K1C15_SHEEP|,5,561,289,9,10,850,19,850
1042,sp|K1C9_HUMAN|,40,1683,1683,54,42,3366,96,3366
273,sp|K22E_HUMAN|,34,1496,1303,46,40,2799,86,2799
343,sp|K2C1_HUMAN|,64,3366,2696,111,89,6062,200,6062
805,sp|TRY1_BOVIN|,6,0,380,0,0,380,0,380
142,sp|TRYP_PIG|,14,0,344,86,41,344,127,344
